CHF        = CHF, HTNWCHF, HHRWCHF, HHRWHRF
VALVE      = VALVE
PULMCIRC   = PULMCIRC
PERIVASC   = PERIVASC
HTN	   = HTN
HTNCX      = HTNCX, HTNPREG, HTNWOCHF, HTNWCHF, HRENWORF, HRENWRF, HHRWOHRF, HHRWCHF, HHRWRF, HHRWHRF, OHTNPREG
PARA       = PARA
NEURO      = NEURO
CHRNLUNG   = CHRNLUNG
DM         = DM
DMCX       = DMCX
HYPOTHY    = HYPOTHY
RENLFAIL   = RENLFAIL, HRENWRF, HHRWRF, HHRWHRF
LIVER      = LIVER
ULCER      = ULCER
AIDS       = AIDS
LYMPH      = LYMPH
METS       = METS
TUMOR      = TUMOR
ARTH       = ARTH
COAG       = COAG
OBESE      = OBESE
WGHTLOSS   = WGHTLOSS
LYTES      = LYTES
BLDLOSS    = BLDLOSS
ANEMDEF    = ANEMDEF
ALCOHOL    = ALCOHOL
DRUG       = DRUG
PSYCH      = PSYCH
DEPRESS    = DEPRESS
HTNWOCHF   = HTNWOCHF
HTNWCHF    = HTNWCHF
HRENWORF   = HRENWORF
HRENWRF    = HRENWRF
HHRWOHRF   = HHRWOHRF
HHRWCHF    = HHRWCHF
HHRWRF     = HHRWRF
HHRWHRF    = HHRWHRF
OHTNPREG   = OHTNPREG
